h h h h h h h h h h h h h h h h
h h h h h h h h h h h h h h h h
h h h h h h h h h h h h h h h h
h h h h h O O O O O O h h h h h
h h h h O O . . . . L O h h h h
h h h h O . . . . . . O h h h h
h h h h O . . o . . . O h h h h
# #+p L . . . . . . . . O h h h h
h h h h O . . M0 M0 M0 M0 O h h h h
h h h h O . . . . . . O h h h h
h h h h O O . . . . O O h h h h
h h h h h O O O O O O h h h h h
h h h h h h h L h h h h h h h h
h h h h h h h . G h h h h h h h
h h h h h h h h h h h h h h h h
h h h h h h h h h h h h h h h h