# # # # # # . . . . # # # # # #
# # # # # # . . . . . . . . . #
# . . . . # # # # # . . . . . #
# h M0 M0 M0 M0 . . # # . . . . . #
# . . . . . . . . h h h h h . #
# . . . . . . . . . h h . . . #
# . . . . . . . . . h . . h h #
# . . . . . . . . . h f . h h #
# . . . . . . . . . h . . h h #
# . . . . . . . . . h h . h h #
h h f h h h . . . . h h . h h #
h h . . . h . . . . h h h h h #
h h . h . h . . . . . . . h h h
h h . . . h . . . . h h h h h h
h h h h h h . . p . h h h h h h
h h h h # # . . . . # # h h h h