.+#+#+# .+#+#+#+# .+#+#+# .+#+#+#+# .+#+#+# .+#+#+#+# .+#+#+# .+#+#+#+# .+#+#+# .+#+#+#+# .+#+#+# .+#+#+#+# .+#+#+# .+#+#+#+# .+#+#+# .+#+#+#+#
+ + + + + . . . . . . . . . . .
+ + + + . . . . . . . . . . . .
+ + + . . . . . . . . . . . . .
+ + . . . . . . . . . . . . . .
+ + . . . . . . . . . . . . . .
+ + . . . . . . . . . . . . . .
+ + . . . . . . . . . . . . . .
+ + . . . . . . . . . . . . . .
+ + . . . . . . . . . . . . . .
+ + . . . . . . . . . . . . . .
+ + . . . . . . . . . . . . . .
+ + . . . . . . . . . . . . . .
+ + + . . . . . . . . + + . . .
+ + + + + . . + + + + + + + + .
+ + + + + + + + + + + + + + + +