# # # # # # . . . . # # # # # #
# . . . . . . . . . . . . . . #
# . . . . . . . . . . . . . . #
# . . . . . . . . . . . . . . #
# . . . . . . . . . . . . . . #
# . . # # # # # . . . . . . . #
# . . # # # # # . . . . . . . #
# . . # # # # # . . . . . . . #
# . . # # l # # . . . . . . . #
# . . . . . . . . . . . . . . #
# . . . . . . . . . . . . . . #
# . . . . . . . . . . . . . . #
# . . . . . . . . . . . . . . #
# . . . . . . . p . . . . . . #
# . . . . . . . . . . . . . . #
# # # # # # . . . . # # # # # #