+ + + + + + + + + + + + + + + +
+ + + + + + . . . . . + + + + +
+ + + + . . . . . . . . . + + +
+ + + . . . . . . . . . . . + +
+ + . . . . . . . . . . . . + +
+ . . . . . . . . . . . . . + +
+ . . . . . . . . . . . . . . +
. . . . . . . . . . . . . . . +
+ + . . . . . . . . . . . . . +
+ + . . . . . . . . . . . . . +
+ + + . . . . . . . . . . . + +
+ + + + . . . . . . . . . + + +
+ + + + + + . . . . . + + + + +
+ + + + + + + + + + + + + + + +
+ + + + + + + + + + + + + + + +
+ + + + + + + + + + + + + + + +