# # # # # # # # # # # # # # # #
# . . # g g g g g g . . . . . #
# . . # g g g g g g . . . . . #
# . . . g g # # g g . . M0 M0 . #
# . . . g g # # g g . . M0 . . #
# . . # g g g g g g # . . . . #
. . . # g g g g g g # . . . . .
. . . # # # g g g g . . . p . .
. . . # h h g g g g . . . . . .
. . . # h h g g g g . . . . . .
# # # # # # # # # # # . . . . #
# # # # # # # # # # # . . . . #
. . . . . . . . . f h . . . . #
. . . . . . . . . . # . . . . #
. . . . . . . . . . # . . . . #
# # # # # # . . . . # # # # # #