h h h h h h h h h h h h h h h h
h h h h h h h h h h h h h h h h
h h h h h h h h h h h h h h h h
h h . . . . h h h h h h h h h h
h h i h h i h h h h h h h h h h
h h i h h i h h h h h h h h h h
h h i h h i h h h h . . h h h h
h h i h h i h h . . h h . . h h
h . i . . i . . . . . . . . p .
h . i . . i . . . . . . . . . .
h h i h h i h h . . h h . . h h
h h i h h i h h h h . . h h h h
h h i h h i h h h h h h h h h h
h h i h h i h h h h h h h h h h
. . . h h . . G h h h h h h h h
h h h h h h h h h h h h h h h h