# # # # # # . . . . # # # # # #
# . . . . . . . p . . . . . . #
# . . . . . . . . . . . . . . #
# . . . . . . . . . . . . . . #
# . . . . . . . . . . . . . . #
# . . . . . . . . . . . . . . #
# . . . . . . . . . . . . . . .
# . . . . . . . . . . . . . . .
# . . . . . . . . . . . . . . .
# . . . . . . . . . . . . . . .
# . . . . . . . . . . . . . . #
# . . . . . . . . . . . . . . #
# . . . . . . . . . . . . . . #
# . . . . . . . . . . . . . . #
# . . . . . . . . . . . . . . #
# # # # # # . . . . # # # # # #