# # # # # # # # # #
# . . . . . # . . #
# . e # . . . . . #
# . . . . # # . e #
# . # . # . . . . #
# . . . . . # . . #
# . # . . . # . . #
# # p p . . . . e+p #
# . . . . # . . . #
# # # # # # # # # #
