# # # # # # # # # #
# . . . . . # . . #
# . e # . . . . . #
# . . . . # # . e #
# . # . # i . . . #
# . . . . i # . . #
# . # . . i # . . #
# # p p . i . . e+p #
# . . . . # . . . #
# # # # # # # # # #
