# # # # # # # # # #
# . . . . . # . . #
# . e # . . . . . #
# . . . . # # M1 . #
# . # . # i . M0 . #
# . . b . i # M0 . #
# . # b . i # . i #
# # p . . i . . i #
# . . . . # . . . #
# # # # # # # # # #
