# # # # # # # # # #
# . . . . . # . . #
# . e # . . . . . #
# . . . . # # M1 e #
# . # . # i . M0 . #
# . . b . i # M0 . #
# . # b . i # . . #
# # p . . i . . e #
# . . . . # . . . #
# # # # # # # # # #
