# # # # # # # # # #
# . . . . . # . . #
# . e # . . . . . #
# . . . . # # . e #
# . # . # i . . . #
# . . b . i # . . #
# . # b . i # . . #
# # p . . i . . e #
# . . . . # . . . #
# # # # # # # # # #
