# # # # # # # # # #
# . . . . . # . . #
# . e # g g g . . #
# . . . . # # M1 . #
# . # . # i . M0 . #
# . . b . i # M0 i #
# . # b . i # . i #
# # p . f i h h h #
# . . . . . h h h #
# # # # # # # # # #
