##########
#.......e#
#........#
#........#
#...#....#
#........#
#.#...#..#
##p......#
#p......e#
##########
