# # # # # # # # # # # # # # # #
# . . . . . . . . . . . . . . #
# . . . . . . . . . . . . . . #
# . . . . . . . . . . . . . . #
# . . . . . . . . . . . . . . #
# . . . . . . . . . . . . . . #
. . . . . . . . . . . . . . . .
. . . . . . . . . . . . . . . .
. . . . . . . . . . . . . . . .
. . . . . . . . . . . . . . . .
# . . . . # # # # # # # # # # #
# . . . . # # # # # # # # # # #
# . . . . # . . . . . . . . . .
# . . . . # . . . . . . . . . .
# . . . . # . . . . . . . . . .
# # # # # # . . . . # # # # # #