+ + + + + + + + + + + + + # + +
+ + + + + + + + + + + + + #+p + +
+ + + + + + + + + + + + + # + +
+ + . . .+# .+# .+# .+# .+# .+# .+# .+# .+# # . +
+ + . . .+# .+# .+# .+#+f .+# .+# .+# . . . . +
+ + . . .+# .+# .+# .+# .+# .+# .+# . . . . +
+ + . . .+# .+# .+# .+# .+# .+# .+# .+Sl . . . +
+ + . . . . + . . . . . . . . +
+ + . . . . + . . . . . . . . +
+ + . . . . + . . . . . . . . +
+ + . . . . + . . . . . . . . +
+ + . . . . + + + + + + + + + +
+ + . . . . + + + + + + + + + +
+ + . . . . + + + + + + + + + +
+ + . . . . + + + + + + + + + +
+ + . . . . + + + + + + + + + +