h # # # # # . . . . # h h h h h
h # . . . . . . . . # # h h h h
h # . . . . . p . . . # # h h h
# # . . . . . . . . . . # # h h
# . . . . M0 . . . . . . . # h h
. . . . . . . o O O O . . # # #
. . . . . . . . . . O O . . . .
. . . . . . . . . . O O . . . .
. . . . . . . . . . O O . . . .
. . . . . . . . . . O O . . . .
. . . . . . O O O O O O . . . .
. . . . . . O O O O O O . . . .
. . . . . . O O O O O O . . . .
. . . . . . . . . . . . . . . .
. . . . . . . . . . . . . . # #
. . . . . . . . . . . . . . h h