+ + + + + . . . . . . . . . + +
+ + + + + . . . . . . . . . + +
+ + + + + + . . . . . . . . + +
+ + + + + + . . . . . . . . + +
+ + + + + + . . . . . . . . + +
+ + + + + + + . . . . . . + + +
+ + + + + + + . . . . . . + + +
+ + + + + + + . . . . . . + + +
+ + + + + + + . . . . . . + + +
.+# .+# .+# .+# # .+# + + . . . . + + + +
. . . .+# .+#+G .+# + + . . . . + + + +
. . . .+# .+# .+# + + . . . . + + + +
.+# .+# .+# .+# .+# .+# + + . . . . + + + +
+ + + + + + + + + . . + + + + +
+ + + + + + + + + . .+p + + + + +
+ + + + + + + + + . . + + + + +