+ + + + + + + + + + + + + # + +
+ + + + + + + + + + + + + .+#+p + +
+ + + + + + + + + + + + + # + +
+ + . . .+# .+# .+# .+# .+# .+# .+# .+# .+# # . +
+ + . . .+# .+# .+# .+#+f .+# .+# .+# . . . . +
+ + . . .+# .+# .+# .+# .+# .+# .+# . . . . +
+ + . . .+# .+# .+# .+# .+# .+# .+Sl# . . . . +
+ + . . . . + . . . . . . . . +
+ + . . . . + . . . . . . . . +
+ + . . . . + . . . . . . . . +
+ + . . . . + . . . . . . . . +
+ + . . . . + + + + + + + + + +
+ + . . . . + + + + + + + + + +
+ + . . . . + + + + + + + + + +
+ + . . . . + + + + + + + + + +
+ + . . . . + + + + + + + + + +